mLine:10
mLie:10
playerX:1
playerY:1
1 1 1 1 1 1 1 1 1 1
1 2 0 0 0 0 0 0 0 1
1 0 0 0 0 0 4 0 0 1
1 0 5 0 0 0 0 0 0 1
1 0 0 0 0 0 4 0 0 1
1 0 6 0 0 0 0 0 0 1
1 0 0 0 0 0 0 0 0 1
1 0 0 7 0 0 0 4 0 1
1 0 0 0 0 0 0 0 0 1
1 1 1 1 1 1 1 1 1 1