11111
12001
103310111
103010141
111011141
011000041
010001001
010001111
011111