011111
0100111
0123001
11101011
14101001
14300101
14000301
11111111