2
15 15
###############
#             #
### ##  ###   #
### ##  ###   #
###     ###   #
### ### ###   #
###  B  ##### #
###           #
####### ### ###
#       ### ###
#  ####  ## ###
# ##     ## ###
# ##     ######
####          E
########E######
8 15
###############
#            ##
#####  ## #####
##   B###B#####
## ## ### #####
## ## #   #####
##            E
##E######E#####