00111000
00141000
00101111
11130341
14032111
11113100
00014100
00011100
