011110
110010
102310
113011
110301
143001
144541
111111
