111110000
100010000
103210111
103310141
111011141
011000041
010001001
010001111
011111000