44444444444
41113133334
42333131134
413****1334
4163*331314
43363333334
43311113334
43333613314
41113313664 
44444444444