4444444444
4133331334
43*1131334
4336133314
43313**334
43*3313334
4**3311334
4333333334
4231111334
4661166634
4444444444