44444444
46333334
46***134
41133334
4333**34
42*31314
41663664
44444444