4444444444444
4111111111114
4113331333114
4113*****3114
4113*3*3*3114
411333333*314
411311113*314
41326666*3314
4136666666114
4111111111114
4444444444444