4444444444444
4111113333334
433336*113*34
4313113133*14
4313113113334
4313333333334
4313331333334
4333131131134
4211633363334
4444444444444