6 9
  *****  
*** & ***
* ##### *
* @@@@@ *
*   *   *
*********