6 6
******
*@  &*
*##  *
*  * *
*  @ *
******