1 3
0 0 0 0 0 0 0 0 0 0 0 0 0
0 0 0 0 0 0 0 0 0 0 0 0 0
0 0 0 0 1 1 1 1 0 0 0 0 0
0 0 0 0 1 0 0 1 1 1 0 0 0
0 0 1 1 1 0 0 0 0 1 0 0 0
0 0 1 0 0 6 4 1 0 1 0 0 0
0 0 1 0 0 3 6 0 0 1 0 0 0
0 0 1 1 1 0 2 1 1 1 0 0 0
0 0 0 0 1 0 0 1 0 0 0 0 0
0 0 0 0 1 1 1 1 0 0 0 0 0
0 0 0 0 0 0 0 0 0 0 0 0 0
0 0 0 0 0 0 0 0 0 0 0 0 0
2 3
0 0 0 0 0 0 0 0 0 0 0 0 0
0 0 0 0 1 1 1 1 0 0 0 0 0
0 0 0 1 1 0 0 1 0 0 0 0 0
0 0 0 1 0 2 0 1 0 0 0 0 0
0 0 0 1 0 3 0 1 0 0 0 0 0
0 0 0 1 0 6 0 1 0 0 0 0 0
0 0 0 1 0 6 0 1 1 0 0 0 0
0 0 0 1 1 4 0 0 1 0 0 0 0
0 0 0 0 1 0 1 0 1 0 0 0 0
0 0 0 0 1 0 0 0 1 0 0 0 0
0 0 0 0 1 1 1 1 1 0 0 0 0
0 0 0 0 0 0 0 0 0 0 0 0 0
3 9
0 0 0 0 0 1 1 1 1 1 1 1 0
0 0 0 0 0 1 0 0 1 0 0 1 0
0 0 0 0 0 1 0 0 3 3 0 1 0
1 1 1 1 1 1 0 3 1 0 0 1 0
1 4 4 4 1 1 1 0 1 0 0 1 1
1 4 0 0 1 0 0 3 0 1 0 0 1
1 4 0 0 0 0 3 0 3 0 3 0 1
1 4 0 0 1 0 0 3 0 1 0 0 1
1 4 4 4 1 1 1 0 1 0 0 1 1
1 1 1 1 1 1 0 3 0 0 0 1 0
0 0 0 0 0 1 0 2 1 0 0 1 0
0 0 0 0 0 1 1 1 1 1 1 1 0