000000000
051111110
011121110
011000000
011111110
011111110
000000110
011811110
000000000