000000000
051011110
011012110
011000110
011111110
011000000
011111110
011111180
000000000