000000000
050111110
010121110
010000110
011111110
011111110
011000000
011111180
000000000