4444444444444444444444444
2111111111111111111111111
3333333333331*13333*13331
1311111113131313131113131
1333133333131333133333131
1111131111131311111111131
1333331333331333133333331
1311111313111131131113111
13333*1313113331131313331
1311111313113111131311131
1333331313333333331333331
1111111311111111111*13111
1333333333331333331333131
1311131111111313131311131
1313331333133313131333331
1311111313111113111111131
1333333313333*13333333131
1311111111111113111113131
13133333333333131333331*1
1311131311131311131113331
1313331313331333331333131
1313111313111311111111131
1333331*13333333333333136
1111111111111111111111111
5555555555555555555555555

