____#####__________
____#---#__________
____#$--#__________
__###--$##_________
__#--$-$-#_________
###-#-##-#___######
#---#-##-#####--..#
#-$--$----------..#
#####-###-#@##--..#
____#-----#########
____#######________