############__
#..--#-----###
#..--#-$--$--#
#..--#$####--#
#..----@-##--#
#..--#-#--$-##
######-##$-$-#
__#-$--$-$-$-#
__#----#-----#