________#####____
________#---#####
________#-#$##--#
________#-----$-#
#########-###---#
#....--##-$--$###
#....----$-$$-##_
#....--##$--$-@#_
#########--$--##_
________#-$-$--#_
________###-##-#_
__________#----#_
__________######_