____##########_____
#####--------####__
#-----#---$--#@-#__
#-#######$####--###
#-#----##-#--#$-..#
#-#-$--$--#--#--#.#
#-#-$--#-----#$-..#
#-#--###-##-----#.#
#-###--#--#--#$-..#
#-#----#-$####--#.#
#-#$---$--$--#*-..#
#----$-#-$-$-#--#.#
####-$###----#*-..#
___#----$$-###....#
___#------##_######
___########________